# Dynamic obstacles with movement patterns
S111D1111111111D11111
111111111111111111111
11D111111D11111111D11
111111111111111111111
111111111111111111111
11D111111D11111111D11
111111111111111111111
111111111111111111111
11D111111D11111111D11
111111111111111111111
111111111111111111111
11D111111D11111111D11
111111111111111111111
111111111111111111111
11D111111D11111111D11
111111111111111111111
111111111111111111111
11D111111D11111111D11
111111111111111111111
11111111111111111111D
