S323213232132321323213232132
32321X32321X32321X32321X32321
2321323213232132321323213232
321X32321X32321X32321X32321X
2132321323213232132321323213
21X32321X32321X32321X32321X3
3213232132321323213232132321
X32321X32321X32321X32321X323
1323213232132321323213232132
32321X32321X32321X32321X32321
2321323213232132321323213232
321X32321X32321X32321X32321X
2132321323213232132321323213
21X32321X32321X32321X32321X3
3213232132321323213232132321
X32321X32321X32321X32321X323
1323213232132321323213232132
32321X32321X32321X32321X32321
2321323213232132321323213232
321X32321X32321X32321X32321X
2132321323213232132321323213
21X32321X32321X32321X32321X3
3213232132321323213232132321
X32321X32321X32321X32321X323
1323213232132321323213232132
32321X32321X32321X32321X32321
2321323213232132321323213232
321X32321X32321X32321X32321X
2132321323213232132321323213
323213232132321323213232132D
