S2231122311223112231
231X32213X32213X3221
31223312233122331223
122X31122X31122X3112
22311223112231122311
31X32213X32213X32213
12233122331223312233
22X31122X31122X31122
33112231122311223112
1X32213X32213X32213X
23312233122331223312
2X31122X31122X31122X
31122311223112231122
X32213X32213X32213X3
33122331223312233122
2X31122X31122X31122X
11223112231122311223
32213X32213X32213X32
31223312233122331223
1223112231122311223D
