S111111111
1111X11111
1111X11111
1111X11111
1111111111
1111111111
11X1111111
11X1111111
11X1111111
111111111D
